WE ./assets/wall2.xpm
NO ./assets/wall8.xpm
EA ./assets/wall9.xpm
SO ./assets/wall7.xpm

C 135,206,235
F 116,102,59


1111111111111111111111111111111111111111111111111111
1000000000000000000000000000000000000000000000000001
1000000000000000000000000000000000000000000000000001
1000000000000000000000000000000000000000000000000001
1000000000000000000000000000000000000000000000000001
1000E00000000000000000000000000000000000000000000001
1000000000000011100011110001111000111000000000000001
1000000000000000100000010000001000001000000000000001
1000000000000000100011110001111000001000000000000001
1000000000000000100000010000001000001000000000000001
1000000000000011110011110001111000001000000000000001
1000000000000000000000000000000000000000000000000001
1000000000000000000000000000000000000000000000000001
 111111111111111111111111111111111111111111111111111
