NO assets/wall5.xpm

SO ./assets/wall3.xpm

WE ./assets/wall6.xpm

EA ./assets/wall7.xpm

F 0,100,0

C 25,30,0




        1111111111111111111111111
        100001 100110000000000001
        1011001001110000000000001
        1001000000000000000000001            1111111111111111111111
111111111011000000000000000001111            1000000000000000000001
10000000001100000110010111111111111          1111111111111111111111
11110111111111011100000010001
11110111111001011101010010001
11000000110100011100000010001
10000000000000000000000000111
10000000000000000001010000001
11000001110101011111011110S0111
11110111 1110101 101111010001
11111111 1111111 111111111111
