
NO ./assets/wall9.xpm

SO ./assets/wall2.xpm

WE ./assets/wall7.xpm

EA ./assets/wall1.xpm

F 220,100,0

C 225,30,0



111111111
10000001
10000111
1101101111
110E101111
1100001111
1111111111
