
NO ./assets/Brick-Textures.xpm

SO ./assets/Brick-Textures.xpm

WE ./assets/Brick-Textures.xpm

EA ./assets/Brick-Textures.xpm

F 220,100,0

C 225,30,0



111111111
1100N111
11101
1111111111